n;a;b;n;n;n;a;n
a;b;n;a;b;n;n;n
b;a;n;n;n;n;n;n
a;n;n;n;b;a;a;n
n;b;n;a;n;a;b;n