n;a;n;a;n;b;n;n
n;a;n;b;n;n;a;b
n;n;a;n;n;n;n;a
n;n;n;n;a;n;b;a
n;a;n;n;n;a;n;b