b;n;n;n;n;n;n;a
b;n;b;n;a;n;n;a
n;n;n;n;n;n;n;b
n;b;a;n;b;n;a;n
b;n;n;b;a;b;n;n