a;a;b;a;a;a;a;n
b;a;n;n;n;n;b;n
n;n;n;b;b;n;n;a
n;n;a;n;a;a;n;n
a;n;n;n;n;b;b;n