n;n;a;n;n;a;n;n
a;n;n;b;a;a;b;n
b;b;n;n;n;n;n;n
n;n;n;b;n;n;n;a
n;b;n;n;n;b;a;n