b;b;a;n;a;b;b;n
n;n;b;n;n;n;n;a
a;n;b;n;n;n;b;n
n;b;n;a;n;a;a;a
n;n;n;a;b;n;n;b