n;n;b;n;n;n;n;a
a;n;b;n;b;b;n;n
n;n;n;n;n;b;n;n
n;a;n;a;b;a;n;n
n;a;n;b;n;a;n;b