n;a;b;n;n;n;n;n
n;a;n;b;b;n;a;n
n;a;n;b;n;n;a;n
n;n;n;b;n;n;b;b
b;a;n;n;a;n;a;b