n;n;b;n;n;n;n;n
n;b;n;b;n;n;n;n
b;n;n;b;n;n;a;n
n;n;n;n;n;b;a;b
n;b;n;a;a;b;n;n